##################################
#                                #
#  *   ##   *    ##    *         #
#          ###                   #
#  @  ##       ##   ###       E  #
#       *   ##         *         #
#  ###           ##              #
#          *            *        #
##################################
