####################
#                  #
#  *     *         #
#       ###        #
#  @             E #
#     ###          #
#        *   *     #
#                  #
####################
