############################
#                          #
#  *   ###    *            #
#                          #
#  @  #   #      ###     E #
#        *   ###           #
#   ###            *       #
#                          #
############################
